#######################################
# Syntax Coloring Map
#######################################

#######################################
# Datatypes (KEYWORD1)
#######################################

SFE_QUAD_Sensors_sprintf	KEYWORD1
SFE_QUAD_Sensor	KEYWORD1
SFE_QUAD_Sensors	KEYWORD1
SFE_QUAD_Sensors__SD	KEYWORD1
SFE_QUAD_Sensors__SdFat	KEYWORD1
SFE_QUAD_Sensors__LittleFS	KEYWORD1
SFE_QUAD_Sensors__EEPROM	KEYWORD1
SFE_QUAD_Sensor_Setting_Type_e	KEYWORD1
SFE_QUAD_Sensor_Every_Type_t	KEYWORD1
SFEQUADSensorType	KEYWORD1

SFE_QUAD_Menu	KEYWORD1
SFE_QUAD_Menu_sprintf	KEYWORD1
SFE_QUAD_Menu_Item	KEYWORD1
SFE_QUAD_Menu_Variable_Type_e	KEYWORD1
SFE_QUAD_Menu_Every_Type_t	KEYWORD1

#######################################
# Methods and Functions (KEYWORD2)
#######################################

_dtostrf	KEYWORD2
_etoa	KEYWORD2
expStrToDouble	KEYWORD2
setPrecision	KEYWORD2
getPrecision	KEYWORD2

deleteSensorStorage	KEYWORD2
getSensorName	KEYWORD2
getNumI2cAddresses	KEYWORD2
getI2cAddress	KEYWORD2
detectSensor	KEYWORD2
beginSensor	KEYWORD2
initializeSensor	KEYWORD2
setCustomInitializePtr	KEYWORD2
getSenseCount	KEYWORD2
getSenseName	KEYWORD2
getSenseNameMaxLen	KEYWORD2
getSenseReading	KEYWORD2
getSettingCount	KEYWORD2
getSettingName	KEYWORD2
getSettingNameMaxLen	KEYWORD2
getSettingType	KEYWORD2
setSetting	KEYWORD2
getConfigurationItemCount	KEYWORD2
getConfigurationItemName	KEYWORD2
getConfigurationItemNameMaxLen	KEYWORD2
getConfigurationItemType	KEYWORD2
getConfigurationItem	KEYWORD2
setConfigurationItem	KEYWORD2

sensorFactory	KEYWORD2
setWirePort	KEYWORD2
enableDebugging	KEYWORD2
setMenuPort	KEYWORD2
detectSensors	KEYWORD2
beginSensors	KEYWORD2
initializeSensors	KEYWORD2
setCustomInitialize	KEYWORD2
getSensorReadings	KEYWORD2
getSensorNames	KEYWORD2
getSenseNames	KEYWORD2
sensorExists	KEYWORD2
loggingMenu	KEYWORD2
getMenuChoice	KEYWORD2
settingMenu	KEYWORD2
getSettingValueDouble	KEYWORD2
getSensorAndMenuConfiguration	KEYWORD2
applySensorAndMenuConfiguration	KEYWORD2

beginStorage	KEYWORD2
writeConfigurationToStorage	KEYWORD2
readConfigurationFromStorage	KEYWORD2
endStorage	KEYWORD2

printDouble	KEYWORD2
dtostrf	KEYWORD2
setPrecision	KEYWORD2
getPrecision	KEYWORD2

setMenuPort	KEYWORD2
setDebugPort	KEYWORD2
addMenuItem	KEYWORD2
addMenuItem	KEYWORD2
getMenuItemVariableType	KEYWORD2
getMenuItemVariable	KEYWORD2
setMenuItemVariable	KEYWORD2
setMenuItemVariableMin	KEYWORD2
setMenuItemVariableMax	KEYWORD2
openMenu	KEYWORD2
getMenuChoice	KEYWORD2
getValueDouble	KEYWORD2
getValueText	KEYWORD2
getNumMenuVariables	KEYWORD2
getMenuVariableAsCSV	KEYWORD2
updateMenuVariableFromCSV	KEYWORD2
getMenuItemNameMaxLen	KEYWORD2
menuItemExists	KEYWORD2
setMenuTimeout	KEYWORD2
setMaxTextChars	KEYWORD2
setSupportsBackspace	KEYWORD2

#######################################
# Constants (LITERAL1)
#######################################

INCLUDE_SFE_QUAD_SENSOR_ALL	LITERAL1
INCLUDE_SFE_QUAD_SENSOR_ADS122C04	LITERAL1
INCLUDE_SFE_QUAD_SENSOR_AHT20	LITERAL1
INCLUDE_SFE_QUAD_SENSOR_BME280	LITERAL1
INCLUDE_SFE_QUAD_SENSOR_CCS811_5A	LITERAL1
INCLUDE_SFE_QUAD_SENSOR_CCS811_5B	LITERAL1
INCLUDE_SFE_QUAD_SENSOR_LPS25HB	LITERAL1
INCLUDE_SFE_QUAD_SENSOR_MAX17048	LITERAL1
INCLUDE_SFE_QUAD_SENSOR_MCP9600	LITERAL1
INCLUDE_SFE_QUAD_SENSOR_MICROPRESSURE	LITERAL1
INCLUDE_SFE_QUAD_SENSOR_MS5637	LITERAL1
INCLUDE_SFE_QUAD_SENSOR_MS8607	LITERAL1
INCLUDE_SFE_QUAD_SENSOR_NAU7802	LITERAL1
INCLUDE_SFE_QUAD_SENSOR_QWIICBUTTON	LITERAL1
INCLUDE_SFE_QUAD_SENSOR_SCD30	LITERAL1
INCLUDE_SFE_QUAD_SENSOR_SCD40	LITERAL1
INCLUDE_SFE_QUAD_SENSOR_SDP3X	LITERAL1
INCLUDE_SFE_QUAD_SENSOR_SGP30	LITERAL1
INCLUDE_SFE_QUAD_SENSOR_SGP40	LITERAL1
INCLUDE_SFE_QUAD_SENSOR_SHTC3	LITERAL1
INCLUDE_SFE_QUAD_SENSOR_STC31	LITERAL1
INCLUDE_SFE_QUAD_SENSOR_TMP117	LITERAL1
INCLUDE_SFE_QUAD_SENSOR_UBLOX_GNSS	LITERAL1
INCLUDE_SFE_QUAD_SENSOR_VCNL4040	LITERAL1
INCLUDE_SFE_QUAD_SENSOR_VEML6075	LITERAL1
INCLUDE_SFE_QUAD_SENSOR_VEML7700	LITERAL1
INCLUDE_SFE_QUAD_SENSOR_VL53L1X	LITERAL1
